IFF
An Interactive Fiction by Joseph Farleo, Andrew Slembarski, and Sydney Young
Release 1 / Serial number 150414 / Inform 7 build 6L38 (I6/v6.33 lib 6/12N) SD

Male Sleeping Quarters
This is the male sleeping quarters for this expedition. The walls are covered in movie posters and there are odds and ends, dishes and cups strewn everywhere. Somewhere in this dump there are records of the history-altering discoveries this expedition has made. To the southeast is the common room.

You can see an Alarm Clock, a Wardrobe (closed) and a Backpack (closed) here.

>se
Common Room
Home sweet home for the rest of the expedition. There is a small kitchen area in the corner. All kinds of lab equipment are strewn across the lab table in the middle of the room, scientific research abandoned each morning to persue scientific FIELD research. You are not a scientist and do not understand what the other members of the expedition are doing when they peer at the artefacts they've uncovered and make sounds like 'hmm' and 'fascinating'.
 To the north is the bathroom. The male bedrooms are to the northwest, and the female bedrooms are to the southwest. The door to the east leads outside.

You can see Base Door, Kitchen Table (on which is a sack lunch (closed)), a Lab Table (on which are a microscope, a preserved thoracic sac, an EDP (in which are a Chapter 1 and a Chapter 2) and a laser scalpel) and a bathroom door here.

>sw
Female Sleeping Quarters
Sleeping quarters for the women on this expedition. It's rather rude of you to go snooping around people's personal spaces when they're not around, you know. Tsk. Don't expect to get invited to my house anytime soon. The room is far from tidy, but it seems impeccable compared to the rest of this outpost. There is a first-aid kit atop the side table, and a dresser in the far corner of the room. An Elvish Sword is mounted above one of the beds

You can see a first aid kit (in which are a tampon, a bandage and a granola bar), a Dresser (closed) and an Elvish Sword here.

>open dresser
You open the Dresser, revealing some clothes.

>take clothes
Those really don't suit your style. Also, they do not belong to you. They belong to someone else, who is not you. Please leave the clothes alone.

>ne
Common Room
Home sweet home for the rest of the expedition. There is a small kitchen area in the corner. All kinds of lab equipment are strewn across the lab table in the middle of the room, scientific research abandoned each morning to persue scientific FIELD research. You are not a scientist and do not understand what the other members of the expedition are doing when they peer at the artefacts they've uncovered and make sounds like 'hmm' and 'fascinating'.
 To the north is the bathroom. The male bedrooms are to the northwest, and the female bedrooms are to the southwest. The door to the east leads outside.

You can see Base Door, Kitchen Table (on which is a sack lunch (closed)), a Lab Table (on which are a microscope, a preserved thoracic sac, an EDP (in which are a Chapter 1 and a Chapter 2) and a laser scalpel) and a bathroom door here.

* * *

IFF
An Interactive Fiction by Joseph Farleo, Andrew Slembarski, and Sydney Young
Release 1 / Serial number 150414 / Inform 7 build 6L38 (I6/v6.33 lib 6/12N) SD

Male Sleeping Quarters
This is the male sleeping quarters for this expedition. The walls are covered in movie posters and there are odds and ends, dishes and cups strewn everywhere. Somewhere in this dump there are records of the history-altering discoveries this expedition has made. To the southeast is the common room.

You can see an Alarm Clock, a Wardrobe (closed) and a Backpack (closed) here.

>open wardrobe
You open the Wardrobe, revealing a coat.

>wear coat
(first taking the coat)
You put on the coat.

>open bacpack
You can't see any such thing.

>open backpack
You open the Backpack, revealing a pair of gloves, a hat, a Flashlight and a Flare.

>wear gloves
(first taking the pair of gloves)
You put on the pair of gloves.

>wear hat
(first taking the hat)
You put on the hat.

>take backpack
Taken.

>i
You are carrying:
  a Backpack (open)
    a Flashlight
    a Flare
  a hat (being worn)
  a pair of gloves (being worn)
  a coat (being worn)

>se
Common Room
Home sweet home for the rest of the expedition. There is a small kitchen area in the corner. All kinds of lab equipment are strewn across the lab table in the middle of the room, scientific research abandoned each morning to persue scientific FIELD research. You are not a scientist and do not understand what the other members of the expedition are doing when they peer at the artefacts they've uncovered and make sounds like 'hmm' and 'fascinating'.
 To the north is the bathroom. The male bedrooms are to the northwest, and the female bedrooms are to the southwest. The door to the east leads outside.

You can see Base Door, Kitchen Table (on which is a sack lunch (closed)), a Lab Table (on which are a microscope, a preserved thoracic sac, an EDP (in which are a Chapter 1 and a Chapter 2) and a laser scalpel) and a bathroom door here.

>take sack lunch
Taken.

>i
You are carrying:
  a sack lunch (closed)
  a Backpack (open)
    a Flashlight
    a Flare
  a hat (being worn)
  a pair of gloves (being worn)
  a coat (being worn)

>take laser scalpel
Taken.

>take edp
You're carrying too many things already.

* * *

>wear coat
(first taking the coat)
You put on the coat.

>open backpack
You open the Backpack, revealing a pair of gloves, a hat, a Flashlight and a Flare.

>wear glove
You can't see any such thing.

>wear gloves
(first taking the pair of gloves)
You put on the pair of gloves.

* * *

>wear hat
(first taking the hat)
You put on the hat.

>se
Common Room
Home sweet home for the rest of the expedition. There is a small kitchen area in the corner. All kinds of lab equipment are strewn across the lab table in the middle of the room, scientific research abandoned each morning to persue scientific FIELD research. You are not a scientist and do not understand what the other members of the expedition are doing when they peer at the artefacts they've uncovered and make sounds like 'hmm' and 'fascinating'.
 To the north is the bathroom. The male bedrooms are to the northwest, and the female bedrooms are to the southwest. The door to the east leads outside.

You can see Base Door, Kitchen Table (on which is a sack lunch (closed)), a Lab Table (on which are a microscope, a preserved thoracic sac, an EDP (in which are a Chapter 1 and a Chapter 2) and a laser scalpel) and a bathroom door here.

>e
(first opening Base Door)

Outside the Base
Kind of nippy out here. That is to say, the frigid winds of the surface feel like they're slicing you through to the bone and you are eternally humbled by the vast empty expanse of the surface, which makes you feel very small, and very insignificant, and very cold, but you hate to be melodramatic. To the north, you can see the covered area that houses the snowmobiles.

You can see Base Door here.

>n
Garage
This is the parking area for the snowmobiles. The edges are lined with benches that are covered in tools that you won't need. All the spaces for snowmobiles are empty except for one.

You can see a Garage Door and a Snowmobile here.

>look under snowmobile
You've discovered keys!

>e
You're not going to walk all the way to the dig site. Do you remember what I told you about your tauntaun freezing? The implication is that you'd freeze too. You can't walk there.

>ride snowmobile
You mount the Snowmobile.

>e
(first opening the Garage Door)

Dig Site (on the Snowmobile)
There is a huge crater where a series of expeditions have unearthed layers upon layers of ancient species that have risen in the thawed cycles of this water moon and fallen during the freezing cycles. The moon is a scientific marvel, where new species rise and fall in a cycle of evolution and mass extinction. The crater is surrounded by a lattice of drilling rigs and descends through strata that encompass entire lifetimes of civilizations. To the north is the elevator that leads down the hole. You can see a ladder leading up to the drilling rig. In the distance to the east, you can barely see the outline of the garage door

You can see ladder and a Garage Door here.

>dismount
You dismount the Snowmobile.

Dig Site
There is a huge crater where a series of expeditions have unearthed layers upon layers of ancient species that have risen in the thawed cycles of this water moon and fallen during the freezing cycles. The moon is a scientific marvel, where new species rise and fall in a cycle of evolution and mass extinction. The crater is surrounded by a lattice of drilling rigs and descends through strata that encompass entire lifetimes of civilizations. To the north is the elevator that leads down the hole. You can see a ladder leading up to the drilling rig. In the distance to the east, you can barely see the outline of the garage door

You can see ladder, a Garage Door and a Snowmobile here.

>n
Elevator
Ground Level. Exit is to the south.

>d
ACCESS DENIED - KEYCARD REQUIRED

>s
Dig Site
There is a huge crater where a series of expeditions have unearthed layers upon layers of ancient species that have risen in the thawed cycles of this water moon and fallen during the freezing cycles. The moon is a scientific marvel, where new species rise and fall in a cycle of evolution and mass extinction. The crater is surrounded by a lattice of drilling rigs and descends through strata that encompass entire lifetimes of civilizations. To the north is the elevator that leads down the hole. You can see a ladder leading up to the drilling rig. In the distance to the east, you can barely see the outline of the garage door

You can see ladder, a Garage Door and a Snowmobile here.

>u
Drilling rig
There are controls here for the laser drill used to create the hole in the ice. Try not to break them, double-oh-seven. You can see a coil of rope and a passcard here, along with a space suit.

You can see ladder, a rope, Keycard and Space Suit here.

>take all
rope: Taken.
Keycard: Taken.
Space Suit: Taken.

>d
Dig Site
There is a huge crater where a series of expeditions have unearthed layers upon layers of ancient species that have risen in the thawed cycles of this water moon and fallen during the freezing cycles. The moon is a scientific marvel, where new species rise and fall in a cycle of evolution and mass extinction. The crater is surrounded by a lattice of drilling rigs and descends through strata that encompass entire lifetimes of civilizations. To the north is the elevator that leads down the hole. You can see a ladder leading up to the drilling rig. In the distance to the east, you can barely see the outline of the garage door

You can see ladder, a Garage Door and a Snowmobile here.

>n
Elevator
Ground Level. Exit is to the south.

>d
Elevator
Sublevel 1. Exit is to the south.

>d
Elevator
Sublevel 2. Exit is to the south.

You can see Backup Power Cell here.

* * *

>e
(first opening Base Door)

Outside the Base
Kind of nippy out here. That is to say, the frigid winds of the surface feel like they're slicing you through to the bone and you are eternally humbled by the vast empty expanse of the surface, which makes you feel very small, and very insignificant, and very cold, but you hate to be melodramatic. To the north, you can see the covered area that houses the snowmobiles.

You can see Base Door here.

>take off coat
You take off the coat.

You freeze to death or something. Game Over.

    *** The End ***

Would you like to RESTART, RESTORE a saved game, QUIT or UNDO the last command?

>undo
Outside the Base
[Previous turn undone.]

* * *

>look under snowmobile
You've discovered keys!

>ride snowmobile
You mount the Snowmobile.

>e
(first opening the Garage Door)

Dig Site (on the Snowmobile)
There is a huge crater where a series of expiditions have unearthed layers upon layers of ancient species that have rizen in the thawed cycles of this water moon and fallen during the freezing cycles. The moon is a scientific marvel, where new species rise and fall in a cycle of evolution and mass extinction. The crater is surrounded by a lattice of drilling rigs and decends through strata that encompass entire lifetimes of civilizations. To the north is the elevator that leads down the hole. You can see a ladder leading up to the drilling rig. In the distance to the east, you can barely see the outline of the garage door

You can see ladder, a Garage Door and Elevator Door here.

>dismount
You dismount the Snowmobile.

Dig Site
There is a huge crater where a series of expiditions have unearthed layers upon layers of ancient species that have rizen in the thawed cycles of this water moon and fallen during the freezing cycles. The moon is a scientific marvel, where new species rise and fall in a cycle of evolution and mass extinction. The crater is surrounded by a lattice of drilling rigs and decends through strata that encompass entire lifetimes of civilizations. To the north is the elevator that leads down the hole. You can see a ladder leading up to the drilling rig. In the distance to the east, you can barely see the outline of the garage door

You can see ladder, a Garage Door, a Snowmobile and Elevator Door here.

>u
Drilling rig
There are controls here for the laser drill used to create the hole in the ice. Try not to break them, double-oh-seven. You can see a coil of rope and a passcard here.

You can see ladder, a rope, Keycard and Space Suit here.

>take all
rope: Taken.
Keycard: Taken.
Space Suit: Taken.

>d
Dig Site
There is a huge crater where a series of expiditions have unearthed layers upon layers of ancient species that have rizen in the thawed cycles of this water moon and fallen during the freezing cycles. The moon is a scientific marvel, where new species rise and fall in a cycle of evolution and mass extinction. The crater is surrounded by a lattice of drilling rigs and decends through strata that encompass entire lifetimes of civilizations. To the north is the elevator that leads down the hole. You can see a ladder leading up to the drilling rig. In the distance to the east, you can barely see the outline of the garage door

You can see ladder, a Garage Door, a Snowmobile and Elevator Door here.

>n
(first opening Elevator Door)

Elevator
Ground Level. Exit is to the south.

You can see Elevator Door and Elevator Door here.

>d
(first opening Elevator Door)

Elevator
Level 1. Exit is to the south.

You can see Elevator Door and Elevator Door here.

>s
Artifact room
You are in the artifact room, so called because it appears to be the remains of a city that seems to have faltered in its development during a medieval period. Among the stony alien ruins lie a plethora of ancient artifacts and tools . There is a supply crate in the room, The specimen room is to the west and the ledge room is to the east.

You can see Supply crate (in which is an ice pick) here.

>take all
ice pick: Taken.

You combine the rope with the ice pick to make a makeshift grappling hook. You appear to have secretly been MacGyver all along.

>w
Specimen Room
The artifact room is back to the east.

You can see Portable Laser Jackhammer (Uncharged) here.

>take all
Portable Laser Jackhammer (Uncharged): You use the ice pick to break the tool out of the ice.

Taken.

>e
Artifact room
You are in the artifact room, so called because it appears to be the remains of a city that seems to have faltered in its development during a medieval period. Among the stony alien ruins lie a plethora of ancient artifacts and tools . There is a supply crate in the room, The specimen room is to the west and the ledge room is to the east.

You can see Supply crate (empty) here.

>e
Ledge Room.
Here the ice falters, cascading downward in what may once have been a waterfall in a cup-shaped canyon east of the City Ruins. Beyond and above a series of ledges there is a wall of glyphs that Russeau has been translating.  There is a series of three ledges that crawl across the lip of the round canyon to the Glyph Wall. You can climb up to the first ledge from here. The artifact room is back to the west.

You can see Ledge and Broken Ladder here.

>take all
Broken Ladder: Taken.

>climb ledge
First Ledge
To the north, across the bottomless pit, you see another ledge. A third appears to be above it. The pit is, of course, not literally bottomless. That would be nonsense. It is, in actuality, merely a very deep pit. Certainly deep enough to send your frail mortal frame to a horribly unpleasant demise. Better be careful, hmm?

You can see Ledge here.

>n
You use the nearly broken ladder to make a stereotypically-rickety path across to the other side. You would think that on this expididtion full of doctors and geniuses someone would have thought to make a more permenant bridge, but no, that would make too much sense. Leave the intern to improvize his way across, I'm sure it will be fine. You really home this thing can carry your weight. You are more than a little afraid
Second Ledge
The first ledge is back to the south across the surprisingly finite pit. There is another ledge above you, leading to the Glyph Wall.

>i
You are carrying:
  Portable Laser Jackhammer (Uncharged)
  Makeshift Grappling Hook
  Space Suit
  Keycard
  keys
  a hat (being worn)
  a pair of gloves (being worn)
  a coat (being worn)

>u
You throw your maksehift grappling hook and it catches in the ice. You can now climb the rope to reach the third ledge. Stunning show, good sir. Somewhere in the distance your childhood adventurer hero sheds a single tear.

Third Ledge
Atop the canyon, the world seems eerily still. The snowy world around you is silent and vacant. A sense of peace comes over you here. There is a wall of Mysterious Glyphs that Russeau has been hard at work translating into meanings you can understand. His Translation Matrix lies abandoned in the snow. What happened to him?

You can see Translation Matrix and Mysterious Glyphs here.

>take all
Translation Matrix: Taken.

>d
Second Ledge
The first ledge is back to the south across the surprisingly finite pit. There is another ledge above you, leading to the Glyph Wall.

>s
First Ledge
To the north, across the not-quite-bottomless pit, you see another ledge. A third appears to be above it. The broken ladder now acts as a rickety excuse for a  bridge across the gap. Are you actually going to walk on that?

You can see Ledge here.

>d
Ledge Room.
Here the ice falters, cascading downward in what may once have been a waterfall in a cup-shaped canyon east of the City Ruins. Beyond and above a series of ledges there is a wall of glyphs that Russeau has been translating.  There is a series of three ledges that crawl across the lip of the round canyon to the Glyph Wall. You can climb up to the first ledge from here. The artifact room is back to the west.

You can see Ledge here.

>w
Artifact room
You are in the artifact room, so called because it appears to be the remains of a city that seems to have faltered in its development during a medieval period. Among the stony alien ruins lie a plethora of ancient artifacts and tools . There is a supply crate in the room, The specimen room is to the west and the ledge room is to the east.

You can see Supply crate (empty) here.

>n
Elevator
Level 1. Exit is to the south.

You can see Elevator Door and Elevator Door here.

>d
(first opening Elevator Door)

Elevator
Level 2.

You can see Elevator Door and Backup Power Cell here.

>take all
Backup Power Cell: Taken.

You use the power cell from the elevator to power the jackhammer.

>s
Dim Cavern
This level is significantly darker than the layer above. You are now deep in the ice caves, where very little research has been done. Light glistens off of the walls and cieling of the chamber, casting eeire shadows that obscuree the vague, yet menacing somethings frozen in the walls of the chamber. Your eyes drift across the dancing shadows on the ice until they reach the far wall of the chamber and meet another, much, much larger eye. It seems fixated on you though, frozen solid in ice, it cannot move. In the ice beyond, you see the shilouette of some hideous monster, bigger than any thing you thought could live. Jenkies. You feel the sudden urge to to be very very quiet. There is a patch of thin ice covering the west bottom quarter of an expanse of the chamber some ways down. To the east there seems to be the nose of some bizarre ship protruding from the ice, the rest of it frozen into the floor of the ice cave.

You can see Patch of thin ice here.

>drop portable
Dropped.

>melt ice
If only you had some tool to help you.

>i
You are carrying:
  Translation Matrix
  Makeshift Grappling Hook
  Space Suit
  Keycard
  keys
  a hat (being worn)
  a pair of gloves (being worn)
  a coat (being worn)

>n
Elevator
Level 2.

You can see Elevator Door here.

>u
Elevator
Level 1. Exit is to the south.

You can see Elevator Door and Elevator Door here.

I beg your pardon?

>u
Elevator
Ground Level. Exit is to the south.

You can see Elevator Door and Elevator Door here.

>s
Dig Site
There is a huge crater where a series of expiditions have unearthed layers upon layers of ancient species that have rizen in the thawed cycles of this water moon and fallen during the freezing cycles. The moon is a scientific marvel, where new species rise and fall in a cycle of evolution and mass extinction. The crater is surrounded by a lattice of drilling rigs and decends through strata that encompass entire lifetimes of civilizations. To the north is the elevator that leads down the hole. You can see a ladder leading up to the drilling rig. In the distance to the east, you can barely see the outline of the garage door

You can see Elevator Door, ladder, a Garage Door and a Snowmobile here.

>w
Garage
This is the parking area for the snowmobiles. The edges are lined with benches that are covered in tools that you won't need. All the spaces for snowmobiles are empty except for one.

You can see a Garage Door here.

>s
Outside the Base
Kind of nippy out here. That is to say, the frigid winds of the surface feel like they're slicing you through to the bone and you are eternally humbled by the vast empty expanse of the surface, which makes you feel very small, and very insignificant, and very cold, but you hate to be melodramatic. To the north, you can see the covered area that houses the snowmobiles.

You can see Base Door here.

>w
Common Room
Home sweet home for the rest of the expedition. There is a small kitchen area in the corner. All kinds of lab equipment is strewn across the lab table in the middle of the room, scientific research abandoned each morning to persue scientific FIELD research. You are not a scientist and do not understand what the other members of the expidition are doing when they peer at the artefacts they've uncovered and make sounds like 'hmm' and 'fascinating'.
 To the north is the bathroom. The male bedrooms are to the northwest, and the female bedrooms are to the southwest. The door to the east leads outside.

You can see Base Door, Kitchen Table (on which is a sack lunch (closed)), a Lab Table (on which are a microscope, a preserved thoracic sac, an EDP (in which are a Chapter 1 and a Chapter 2) and a laser scalpel) and a bathroom door here.

>take laser scalpel
Taken.

>nw
Male Sleeping Quarters
This is the male sleeping quarters for this expidition. The walls are covered in movie posters and there are odds and ends, dishes and cups strewn everywhere. Somewhere in this dump there are records of the history-altering discoveries this expidition has made. To the southeast is the common room.

You can see an Alarm Clock, a Wardrobe (empty) and a Backpack (in which are a Flashlight and a Flare) here.

>take flare
Taken.

>se
Common Room
Home sweet home for the rest of the expedition. There is a small kitchen area in the corner. All kinds of lab equipment is strewn across the lab table in the middle of the room, scientific research abandoned each morning to persue scientific FIELD research. You are not a scientist and do not understand what the other members of the expidition are doing when they peer at the artefacts they've uncovered and make sounds like 'hmm' and 'fascinating'.
 To the north is the bathroom. The male bedrooms are to the northwest, and the female bedrooms are to the southwest. The door to the east leads outside.

You can see Base Door, Kitchen Table (on which is a sack lunch (closed)), a Lab Table (on which are a microscope, a preserved thoracic sac and an EDP (in which are a Chapter 1 and a Chapter 2)) and a bathroom door here.

>e
Outside the Base
Kind of nippy out here. That is to say, the frigid winds of the surface feel like they're slicing you through to the bone and you are eternally humbled by the vast empty expanse of the surface, which makes you feel very small, and very insignificant, and very cold, but you hate to be melodramatic. To the north, you can see the covered area that houses the snowmobiles.

You can see Base Door here.

>n
Garage
This is the parking area for the snowmobiles. The edges are lined with benches that are covered in tools that you won't need. All the spaces for snowmobiles are empty except for one.

You can see a Garage Door here.

I beg your pardon?

>e
Dig Site
There is a huge crater where a series of expiditions have unearthed layers upon layers of ancient species that have rizen in the thawed cycles of this water moon and fallen during the freezing cycles. The moon is a scientific marvel, where new species rise and fall in a cycle of evolution and mass extinction. The crater is surrounded by a lattice of drilling rigs and decends through strata that encompass entire lifetimes of civilizations. To the north is the elevator that leads down the hole. You can see a ladder leading up to the drilling rig. In the distance to the east, you can barely see the outline of the garage door

You can see a Garage Door, Elevator Door, ladder and a Snowmobile here.

>n
Elevator
Ground Level. Exit is to the south.

You can see Elevator Door and Elevator Door here.

>d
Elevator
Level 1. Exit is to the south.

You can see Elevator Door and Elevator Door here.

>d
Elevator
Level 2.

You can see Elevator Door here.

>s
Dim Cavern
This level is significantly darker than the layer above. You are now deep in the ice caves, where very little research has been done. Light glistens off of the walls and cieling of the chamber, casting eeire shadows that obscuree the vague, yet menacing somethings frozen in the walls of the chamber. Your eyes drift across the dancing shadows on the ice until they reach the far wall of the chamber and meet another, much, much larger eye. It seems fixated on you though, frozen solid in ice, it cannot move. In the ice beyond, you see the shilouette of some hideous monster, bigger than any thing you thought could live. Jenkies. You feel the sudden urge to to be very very quiet. There is a patch of thin ice covering the west bottom quarter of an expanse of the chamber some ways down. To the east there seems to be the nose of some bizarre ship protruding from the ice, the rest of it frozen into the floor of the ice cave.

You can see Portable Laser Jackhammer (Charged) and Patch of thin ice here.

>drop laser
(the laser scalpel)
Dropped.

>melt ice
This flare might be more useful for something else. There's probably a better tool for this job around here somewhere.

>drop flare
Dropped.

>melt ice
If only you had some tool to help you.

>pick up laser
Which do you mean, the laser scalpel or Portable Laser Jackhammer (Charged)?

>pick up scalpel
Taken.

>melt ice
If only you had some tool to help you.

* * *

>n
Garage
This is the parking area for the snowmobiles. The edges are lined with benches that are covered in tools that you won't need. All the spaces for snowmobiles are empty except for one.

You can see a Garage Door and a Snowmobile here.

>examine snowmobile
A current model hover-snow bike, but you and your friends all just call it a snowmobile, sort of in the same vein of how people call tissues Kleenex. You catch a glimpse of something shiny under the snowmobile.

>look beneath snowmobile
You can't see any such thing.

>look under snowmobile
You've discovered keys!

* * *

>up
Drilling rig
There are controls here for the laser drill used to create the hole in the ice. Try not to break them, double-oh-seven. You can see a coil of rope and a passcard here.

You can see ladder, a rope, Keycard and Space Suit here.

>remove coat
You take off the coat.

>remove hat
You take off the hat.

>remove gloves
You take off the pair of gloves.

>wear space suit
(first taking Space Suit)
You put on Space Suit.

>d
Dig Site
There is a huge crater where a series of expiditions have unearthed layers upon layers of ancient species that have rizen in the thawed cycles of this water moon and fallen during the freezing cycles. The moon is a scientific marvel, where new species rise and fall in a cycle of evolution and mass extinction. The crater is surrounded by a lattice of drilling rigs and decends through strata that encompass entire lifetimes of civilizations. To the north is the elevator that leads down the hole. You can see a ladder leading up to the drilling rig. In the distance to the east, you can barely see the outline of the garage door

You can see ladder, a Garage Door, a Snowmobile and Elevator Door here.

* * *

>n
(first opening Elevator Door)

Elevator
Ground Level. Exit is to the south.

You can see Elevator Door and Elevator Door here.

>d
(first opening Elevator Door)
ACCESS DENIED - KEYCARD REQUIRED

>s
Dig Site
There is a huge crater where a series of expiditions have unearthed layers upon layers of ancient species that have rizen in the thawed cycles of this water moon and fallen during the freezing cycles. The moon is a scientific marvel, where new species rise and fall in a cycle of evolution and mass extinction. The crater is surrounded by a lattice of drilling rigs and decends through strata that encompass entire lifetimes of civilizations. To the north is the elevator that leads down the hole. You can see a ladder leading up to the drilling rig. In the distance to the east, you can barely see the outline of the garage door

You can see Elevator Door, ladder, a Garage Door and a Snowmobile here.

>u
Drilling rig
There are controls here for the laser drill used to create the hole in the ice. Try not to break them, double-oh-seven. You can see a coil of rope and a passcard here.

You can see ladder, a rope and Keycard here.

>take all
rope: Taken.
Keycard: Taken.

>d
Dig Site
There is a huge crater where a series of expiditions have unearthed layers upon layers of ancient species that have rizen in the thawed cycles of this water moon and fallen during the freezing cycles. The moon is a scientific marvel, where new species rise and fall in a cycle of evolution and mass extinction. The crater is surrounded by a lattice of drilling rigs and decends through strata that encompass entire lifetimes of civilizations. To the north is the elevator that leads down the hole. You can see a ladder leading up to the drilling rig. In the distance to the east, you can barely see the outline of the garage door

You can see ladder, Elevator Door, a Garage Door and a Snowmobile here.

>n
Elevator
Ground Level. Exit is to the south.

You can see Elevator Door and Elevator Door here.

>d
(first opening Elevator Door)

Elevator
Level 1. Exit is to the south.

You can see Elevator Door and Elevator Door here.

>e
You can't go that way.

>s
Artifact room
You are in the artifact room, so called because it appears to be the remains of a city that seems to have faltered in its development during a medieval period. Among the stony alien ruins lie a plethora of ancient artifacts and tools . There is a supply crate in the room, The specimen room is to the west and the ledge room is to the east.

You can see Supply crate (in which is an ice pick) here.

>e
Ledge Room.
Here the ice falters, cascading downward in what may once have been a waterfall in a cup-shaped canyon east of the City Ruins. Beyond and above a series of ledges there is a wall of glyphs that Russeau has been translating.  There is a series of three ledges that crawl across the lip of the round canyon to the Glyph Wall. You can climb up to the first ledge from here. The artifact room is back to the west.

You can see Ledge and Broken Ladder here.

>u
First Ledge
To the north, across the bottomless pit, you see another ledge. A third appears to be above it. The pit is, of course, not literally bottomless. That would be nonsense. It is, in actuality, merely a very deep pit. Certainly deep enough to send your frail mortal frame to a horribly unpleasant demise. Better be careful, hmm?

You can see Ledge here.

>climb ledge
Ledge Room.
Here the ice falters, cascading downward in what may once have been a waterfall in a cup-shaped canyon east of the City Ruins. Beyond and above a series of ledges there is a wall of glyphs that Russeau has been translating.  There is a series of three ledges that crawl across the lip of the round canyon to the Glyph Wall. You can climb up to the first ledge from here. The artifact room is back to the west.

You can see Ledge and Broken Ladder here.

>climb ledge
First Ledge
To the north, across the bottomless pit, you see another ledge. A third appears to be above it. The pit is, of course, not literally bottomless. That would be nonsense. It is, in actuality, merely a very deep pit. Certainly deep enough to send your frail mortal frame to a horribly unpleasant demise. Better be careful, hmm?

You can see Ledge here.

>n
You fall down the pit. Dead.

    *** The End ***

Would you like to RESTART, RESTORE a saved game, QUIT or UNDO the last command?

>restart
IFF
An Interactive Fiction by Joseph Farleo, Andrew Slembarski, and Sydney Young
Release 1 / Serial number 150413 / Inform 7 build 6L38 (I6/v6.33 lib 6/12N) SD

Male Sleeping Quarters
This is the male sleeping quarters for this expidition. The walls are covered in movie posters and there are odds and ends, dishes and cups strewn everywhere. Somewhere in this dump there are records of the history-altering discoveries this expidition has made. To the southeast is the common room.

You can see an Alarm Clock, a Wardrobe (closed) and a Backpack (closed) here.

>se
Common Room
Home sweet home for the rest of the expedition. There is a small kitchen area in the corner. All kinds of lab equipment is strewn across the lab table in the middle of the room, scientific research abandoned each morning to persue scientific FIELD research. You are not a scientist and do not understand what the other members of the expidition are doing when they peer at the artefacts they've uncovered and make sounds like 'hmm' and 'fascinating'.
 To the north is the bathroom. The male bedrooms are to the northwest, and the female bedrooms are to the southwest. The door to the east leads outside.

You can see Base Door, Kitchen Table (on which is a sack lunch (closed)), a Lab Table (on which are a microscope, a preserved thoracic sac, an EDP (in which are a Chapter 1 and a Chapter 2) and a laser scalpel) and a bathroom door here.

>eat preserved
You lose.

    *** The End ***

Would you like to RESTART, RESTORE a saved game, QUIT or UNDO the last command?

* * *

>n
Garage
This is the parking area for the snowmobiles. The edges are lined with benches that are covered in tools that you won't need. All the spaces for snowmobiles are empty except for one.

You can see a Garage Door and a Snowmobile here.

>d
You can't go that way.

* * *

>take backpack
Taken.

>se
Common Room
Home sweet home for the rest of the expedition. There is a small kitchen area in the corner. All kinds of lab equipment is strewn across the lab table in the middle of the room, scientific research abandoned each morning to persue scientific FIELD research. You are not a scientist and do not understand what the other members of the expidition are doing when they peer at the artefacts they've uncovered and make sounds like 'hmm' and 'fascinating'.
 To the north is the bathroom. The male bedrooms are to the northwest, and the female bedrooms are to the southwest. The door to the east leads outside.

You can see Base Door, Kitchen Table (on which is a sack lunch (closed)), a Lab Table (on which are a microscope, a preserved thoracic sac, an EDP (in which are a Chapter 1 and a Chapter 2) and a laser scalpel) and a bathroom door here.

>e
(first opening Base Door)

Outside the Base
Kind of nippy out here. That is to say, the frigid winds of the surface feel like they're slicing you through to the bone and you are eternally humbled by the vast empty expanse of the surface, which makes you feel very small, and very insignificant, and very cold, but you hate to be melodramatic. To the north, you can see the covered area that houses the snowmobiles.

You can see Base Door here.

* * *

>w
You're not going to walk all the way to the dig site. Do you remember what I told you about your tauntaun freezing? The implication is that you'd freeze too. You can't walk there.