IFF
An Interactive Fiction by Joseph Farleo, Andrew Slembarski, and Sydney Young
Release 1 / Serial number 150413 / Inform 7 build 6L38 (I6/v6.33 lib 6/12N) SD

Male Sleeping Quarters
This is the male sleeping quarters for this expidition. The walls are covered in movie posters and there are odds and ends, dishes and cups strewn everywhere. Somewhere in this dump there are records of the history-altering discoveries this expidition has made. To the southeast is the common room.

You can see an Alarm Clock, a Wardrobe (closed) and a Backpack (closed) here.

>take backpack
Taken.

>open backpack
You open the Backpack, revealing a pair of gloves, a hat, a Flashlight and a Flare.

>put on gloves
(first taking the pair of gloves)
You put on the pair of gloves.

>put on all
You can't see any such thing.

>put on hat
(first taking the hat)
You put on the hat.

>close backpack
You close the Backpack.

* * *

>put on gloves
(first taking the pair of gloves)
You put on the pair of gloves.

>put on hat
(first taking the hat)
You put on the hat.

* * *

>close backpack
You close the Backpack.

>se
Common Room
Home sweet home for the rest of the expedition. There is a small kitchen area in the corner. All kinds of lab equipment is strewn across the lab tables in the middle of the room, scientific research abandoned each morning to persue scientific FIELD research. You are not a scientist and do not understand what the other members of the expidition are doing when they peer at the artefacts they've uncovered and make sounds like 'hmm' and 'fascinating'.
 To the north is the bathroom. The male bedrooms are to the northwest, and the female bedrooms are to the southwest. The door to the east leads outside.

You can see Base Door, Kitchen Table (on which is a sack lunch (closed)), a Lab Tables (on which are a microscope, a preserved thoracic sac, an EDP (in which are a Chapter 1 and a Chapter 2) and a laser scalpel) and a bathroom door here.

>examine tables
Craig and Reala had been working on examining the molecular structure of the Phosphorescent Space Penguin thoracic sac. Originally used as a mating and warning signal, the sac cells might allow us to create more efficient glow-in-the-dark stuff. But our job isn't to find a use for it anyway. That's the engineers' concern. You just think it's really gross and smells bad and want it gone.

On the Lab Tables are a microscope, a preserved thoracic sac, an EDP (in which are a Chapter 1 and a Chapter 2) and a laser scalpel.

>take scalpel
Taken.

>examine scalpel
A laser scalpel.  It can clean cuts or cauterize a wound. It can even do both at the same time, but that wouldn't be very effective at... anything, really.

>take edp
Taken.

>examine edp
The Environmental Discovery Pager. Each of the archeologists is supposed to have one. Looks like Carl forgot to take his with him. Again. I had better return it to him.

In the EDP are a Chapter 1 and a Chapter 2.

>read chapter 1
It says, 

"A bad start already, dang it. There's a really cool ice cave filled with all sorts of specimens on the first floor of the caverns, but I forgot this darn thing up here again. I left my observations of the species in the cavern on the icy ledge where Russeau was deciphering the glyphs. He said he'd left it there so I could find it again, but I haven't been able to remember to bring it back to base yet. Sadly. my memory has never been impressive."

>examine chapter 2
It says, 

"The second level of the caverns is even more amazing! I still cannot believe I forgot this EDP back here again. I left my notes for that section of the cavern ... shoot, I don't even remember where I put them! Maybe I left hints to its whereabouts. Ugh, why am I so forgetful?! 

I remember Russeau saying something about the first layer's inhabitants being a sort of translating explorative species based on his findings, and he sounded excited to search the seond level for more glyphs from their discoveries. Perhaps they know even more about this planet's history than we do!"

>examine table
On Kitchen Table is a sack lunch (closed).

>take lunch
Taken.

>examine tables
Craig and Reala had been working on examining the molecular structure of the Phosphorescent Space Penguin thoracic sac. Originally used as a mating and warning signal, the sac cells might allow us to create more efficient glow-in-the-dark stuff. But our job isn't to find a use for it anyway. That's the engineers' concern. You just think it's really gross and smells bad and want it gone.

On the Lab Tables are a microscope and a preserved thoracic sac.

>examine sac
Gross.

>cut sac
Cutting it up would achieve little.

>cut sac with scalpel
I only understood you as far as wanting to cut the preserved thoracic sac.

>take sac
Please, no. There is absolutely no way you're taking that with you. I can't blame you, to be honest.

>examine microscope
The microscope has been in Reala's family for generations. Outdated, but still operational.

>look through microscope
Glowy stuff, glowy stuff, and more glowy stuff. Only the biologists really know what to make of whatever the heck this stuff is. All you know is that the mitochondria is the powerhouse of the cell.

>sw
Female Sleeping Quarters
Sleeping quarters for the women on this expedition. It's rather rude of you to go snooping around people's personal spaces when they're not around, you know. Tsk. Don't expect to get invited to my house anytime soon. The room is far from tidy, but it seems impeccable compared to the rest of this outpost. There is a first-aid kit atop the side table, and a dresser in the far corner of the room. An Elvish Sword is mounted above one of the beds

You can see a first aid kit (in which are a tampon, a bandage and a granola bar), a Dresser (closed) and an Elvish Sword here.

>examine sword
This sword is a collectors item of Reala's. She claims it glows blue when danger is near. Riiiight.

>take sword
I'm pretty sure Reala would kill you if you so much as touch her sword, let alone take it.

>i
You are carrying:
  a sack lunch (closed)
  an EDP
    a Chapter 1
    a Chapter 2
  a laser scalpel
  a hat (being worn)
  a pair of gloves (being worn)
  a Backpack (closed)

>examine self
As good-looking as ever.

>examine dresser
You know, you shouldn't go through people's belongings without their permission, especailly when they're away. There are clothes in the dresser. Why would you want to root through people's clothes, anyway? Creep.

>open dresser
You open the Dresser, revealing a clothes.

>examine clothes
They smell nicer than the those in the other room, that's for sure. Why are you going through their clothes? Please stop this.

>take clothes
Those really don't suit your style. Also, they do not belong to you. They belong to someone else, who is not you. Please leave the clothes alone.

>close dresser
You close the Dresser.

>examine room
Female Sleeping Quarters
Sleeping quarters for the women on this expedition. It's rather rude of you to go snooping around people's personal spaces when they're not around, you know. Tsk. Don't expect to get invited to my house anytime soon. The room is far from tidy, but it seems impeccable compared to the rest of this outpost. There is a first-aid kit atop the side table, and a dresser in the far corner of the room. An Elvish Sword is mounted above one of the beds

You can see a first aid kit (in which are a tampon, a bandage and a granola bar), a Dresser (closed) and an Elvish Sword here.

>examine first aid kit
The first aid kit for the team. Kendall must have left it open when she went to restock it with tampons. It doesn't look like she's done so yet.

In the first aid kit are a tampon, a bandage and a granola bar.

>examine tampon
Good for bullet wounds, nose bleeds, and, of course, female hygiene.

>examine bandage
Bandages and old bottles of red liquid will cure almost any wound, as any purveyor of video games will know.

>examine granola bar
It's crunchier than you would like it to be. Why is there a granola bar in a first aid kit, anyway?

>close kit
You close the first aid kit.

>take kit
Taken.

>ne
Common Room
Home sweet home for the rest of the expedition. There is a small kitchen area in the corner. All kinds of lab equipment is strewn across the lab tables in the middle of the room, scientific research abandoned each morning to persue scientific FIELD research. You are not a scientist and do not understand what the other members of the expidition are doing when they peer at the artefacts they've uncovered and make sounds like 'hmm' and 'fascinating'.
 To the north is the bathroom. The male bedrooms are to the northwest, and the female bedrooms are to the southwest. The door to the east leads outside.

You can see Base Door, Kitchen Table, a Lab Tables (on which are a microscope and a preserved thoracic sac) and a bathroom door here.

>ne
You can't go that way.

>nw
Male Sleeping Quarters
This is the male sleeping quarters for this expidition. The walls are covered in movie posters and there are odds and ends, dishes and cups strewn everywhere. Somewhere in this dump there are records of the history-altering discoveries this expidition has made. To the southeast is the common room.

You can see an Alarm Clock and a Wardrobe (closed) here.

>open wardrobe
You open the Wardrobe, revealing a coat.

>take coat
Taken.

>put on coat
You put on the coat.

>examine coat
Puffed up to the brim with the finest Groobler feathers. This blue coat is sure to keep me nice and toasty down to 50 Kelvin. The Groobler has truly incredible plumage. It is your favorite bird.

>se
Common Room
Home sweet home for the rest of the expedition. There is a small kitchen area in the corner. All kinds of lab equipment is strewn across the lab tables in the middle of the room, scientific research abandoned each morning to persue scientific FIELD research. You are not a scientist and do not understand what the other members of the expidition are doing when they peer at the artefacts they've uncovered and make sounds like 'hmm' and 'fascinating'.
 To the north is the bathroom. The male bedrooms are to the northwest, and the female bedrooms are to the southwest. The door to the east leads outside.

You can see Base Door, Kitchen Table, a Lab Tables (on which are a microscope and a preserved thoracic sac) and a bathroom door here.

>e
(first opening Base Door)

Outside the Base
Kind of nippy out here. That is to say, the frigid winds of the surface feel like they're slicing you through to the bone and you are eternally humbled by the vast empty expanse of the surface, which makes you feel very small, and very insignificant, and very cold, but you hate to be melodramatic. To the north, you can see the covered area that houses the snowmobiles.

You can see Base Door here.

>north
Garage
This is the parking area for the snowmobiles. The edges are lined with benches that are covered in tools that you won't need. All the spaces for snowmobiles are empty except for one.

You can see a Garage Door and a Snowmobile here.

>open garage door
You're not going to walk all the way to the dig site. Do you remember what I told you about your tauntaun freezing? The implication is that you'd freeze too. You can't walk there.

>examine snowmobile
A current-model hover snow bike, but you and your friends all just call it a snowmobile, sort of in the same vein of how people call tissues Kleenex. You catch a glimpse of something shiny beneath the snowmobile.

>mount snowmobile
Try though you might, you can't start it without the keys.

>look under snowmobile
You've discovered keys!

>i
You are carrying:
  keys
  a coat (being worn)
  a first aid kit (closed)
  a sack lunch (closed)
  an EDP
    a Chapter 1
    a Chapter 2
  a laser scalpel
  a hat (being worn)
  a pair of gloves (being worn)
  a Backpack (closed)

>take keys
You already have that.

>mount snowmobile
You mount the Snowmobile.

>open garage door
You open the Garage Door.

>e
Dig Site (on the Snowmobile)
There is a huge crater where a series of expiditions have unearthed layers upon layers of ancient species that have rizen in the thawed cycles of this water moon and fallen during the freezing cycles. The moon is a scientific marvel, where new species rise and fall in a cycle of evolution and mass extinction. The crater is surrounded by a lattice of drilling rigs and decends through strata that encompass entire lifetimes of civilizations. To the north is the elevator that leads down the hole. You can see a ladder leading up to the drilling rig. In the distance to the east, you can barely see the outline of the garage door

You can see ladder, a Garage Door and Elevator Door here.

>climb ladder
I don't think much is to be achieved by that.

>take ladder
That's fixed in place.

>examine rig
You can't see any such thing.

>examine ladder
You see nothing special about ladder.

>up
Drilling rig (on the Snowmobile)
There are controls here for the laser drill used to create the hole in the ice. Try not to break them, double-oh-seven. You can see a coil of rope and a passcard here.

You can see ladder, a rope, Keycard and Space Suit here.

>take rope
Taken.

>examine rope
Made of the toughest and most flexible tspace age polymers. This model glows a bright yellow in the dark. 

Couldn't hurt to have one.

>take keycard
Taken.

>take card
You can't see any such thing.

>examine spacesuit
You can't see any such thing.

>examine suit
.

>take suit
Taken.

>down
Dig Site (on the Snowmobile)
There is a huge crater where a series of expiditions have unearthed layers upon layers of ancient species that have rizen in the thawed cycles of this water moon and fallen during the freezing cycles. The moon is a scientific marvel, where new species rise and fall in a cycle of evolution and mass extinction. The crater is surrounded by a lattice of drilling rigs and decends through strata that encompass entire lifetimes of civilizations. To the north is the elevator that leads down the hole. You can see a ladder leading up to the drilling rig. In the distance to the east, you can barely see the outline of the garage door

You can see ladder, a Garage Door and Elevator Door here.

>enter elevator
(first opening Elevator Door)
You could try to use the elevator with the snowmobile, but I don't think that's especially likely to work. Maybe getting off of the snowmobile first would help.

>get off snowmobile
You dismount the Snowmobile.

Dig Site
There is a huge crater where a series of expiditions have unearthed layers upon layers of ancient species that have rizen in the thawed cycles of this water moon and fallen during the freezing cycles. The moon is a scientific marvel, where new species rise and fall in a cycle of evolution and mass extinction. The crater is surrounded by a lattice of drilling rigs and decends through strata that encompass entire lifetimes of civilizations. To the north is the elevator that leads down the hole. You can see a ladder leading up to the drilling rig. In the distance to the east, you can barely see the outline of the garage door

You can see ladder, a Snowmobile, a Garage Door and Elevator Door here.

>enter door
Which do you mean, the Garage Door or Elevator Door?

>enter elevator
(first opening Elevator Door)

Elevator
Ground Level.

You can see Elevator Door and Elevator Door here.

>down
(first opening Elevator Door)

Elevator
Level 1.

You can see Elevator Door and Elevator Door here.

>exit elevaotr door
I only understood you as far as wanting to exit.

>exit
But you aren't in anything at the moment.

>exit elevator door
I only understood you as far as wanting to exit.

>enter
You must supply a noun.

>enter elevator door
Which do you mean, Elevator Door or Elevator Door?

>n
I only understood you as far as wanting to enter north.

>e
You can't go that way.

* * *

>s
Artifact room
You are in the artifact room, so called because it appears to be the remains of a city that seems to have faltered in its development during a medieval period. Among the stony alien ruins lie a plethora of ancient artifacts and tools . There is a supply crate in the room, The specimen room is to the west and the ledge room is to the east.

You can see Supply crate (in which is an ice pick) here.

>take pick
Taken.

You combine the rope with the ice pick to make a makeshift grappling hook. You appear to have secretly been MacGyver all along.

>look around
Artifact room
You are in the artifact room, so called because it appears to be the remains of a city that seems to have faltered in its development during a medieval period. Among the stony alien ruins lie a plethora of ancient artifacts and tools . There is a supply crate in the room, The specimen room is to the west and the ledge room is to the east.

You can see Supply crate (empty) here.

>w
Specimen Room
The artifact room is back to the east.

You can see Portable Laser Jackhammer U here.

>take jackhammer
You use the ice pick to break the tool out of the ice.

Taken.

>examine jackhammer
The power cell appears to be missing. Typical.

>e
Artifact room
You are in the artifact room, so called because it appears to be the remains of a city that seems to have faltered in its development during a medieval period. Among the stony alien ruins lie a plethora of ancient artifacts and tools . There is a supply crate in the room, The specimen room is to the west and the ledge room is to the east.

You can see Supply crate (empty) here.

>e
Ledge Room.
Here the ice falters, cascading downward in what may once have been a waterfall in a cup-shaped canyon east of the City Ruins. Beyond and above a series of ledges there is a wall of glyphs that Russeau has been translating.  There is a series of three ledges that crawl across the lip of the round canyon to the Glyph Wall. The artifact room is back to the west.

You can see Ledge and Broken Ladder here.

>examine broken ladder
You see nothing special about Broken Ladder.

>take ladder
Taken.

>climb ledge
First Ledge
To the north, across the bottomless pit, you see another ledge. A third appears to be above it. The pit is, of course, not literally bottomless. That would be nonsense. It is, in actuality, merely a very deep pit. Certainly deep enough to send your frail mortal frame to a horribly unpleasant demise. Better be careful, hmm?

You can see Ledge here.

>use ladder
You can't see any such thing.

>examine ladder
You see nothing special about Broken Ladder.

>e
You can't go that way.