IFF
An Interactive Fiction by Joseph Farleo
Release 1 / Serial number 150406 / Inform 7 build 6L38 (I6/v6.33 lib 6/12N) SD

Sleeping Quarters Male
Sleeping quarters for the men on this expedition. To the southeast is the common room.

You can see an Alarm Clock, a Wardrobe (closed) and a Backpack (closed) here.

>take clock
That's fixed in place.

* * *

IFF
An Interactive Fiction by Joseph Farleo
Release 1 / Serial number 150406 / Inform 7 build 6L38 (I6/v6.33 lib 6/12N) SD

Sleeping Quarters Male
Sleeping quarters for the men on this expedition. To the southeast is the common room.

You can see an Alarm Clock, a Wardrobe (closed) and a Backpack (closed) here.

>wearing
That's not a verb I recognise.

>examine self
As good-looking as ever.

* * *

IFF
An Interactive Fiction by Joseph Farleo
Release 1 / Serial number 150406 / Inform 7 build 6L38 (I6/v6.33 lib 6/12N) SD

Sleeping Quarters Male
Sleeping quarters for the men on this expedition. To the southeast is the common room.

You can see an Alarm Clock, a Wardrobe (closed) and a Backpack (closed) here.

>sw
You can't go that way.

>se
Main Room
Home sweet home for the rest of the expedition. There is a small kitchen area in the corner. All kinds of lab equipment is strewn across the tables in the middle of the room. 
 To the north is the bathroom. The male bedrooms are to the northwest, and the female bedrooms are to the southwest

* * *

IFF
An Interactive Fiction by Joseph Farleo
Release 1 / Serial number 150406 / Inform 7 build 6L38 (I6/v6.33 lib 6/12N) SD

Sleeping Quarters Male
Sleeping quarters for the men on this expedition. To the southeast is the common room.

You can see an Alarm Clock, a Wardrobe (closed) and a Backpack (closed) here.

>se
Common Room
Home sweet home for the rest of the expedition. There is a small kitchen area in the corner. All kinds of lab equipment is strewn across the tables in the middle of the room. 
 To the north is the bathroom. The male bedrooms are to the northwest, and the female bedrooms are to the southwest. The door to the east leads outside

You can see Base Door, Kitchen Table (on which is Sack Lunch) and a bathroom door here.

>sw
Sleeping Quarters Female

>ne
Main Room

>nw
Sleeping Quarters Male

* * *

>se
Common Room
Home sweet home for the rest of the expedition. There is a small kitchen area in the corner. All kinds of lab equipment is strewn across the tables in the middle of the room. 
 To the north is the bathroom. The male bedrooms are to the northwest, and the female bedrooms are to the southwest. The door to the east leads outside

You can see Base Door, Kitchen Table (on which is Sack Lunch) and a bathroom door here.

>n
(first opening door1)
It's locked. I guess I'll just have to hold it.

Bathroom
You can see door1 here.

>s
Main Room
Home sweet home for the rest of the expedition. There is a small kitchen area in the corner. All kinds of lab equipment is strewn across the tables in the middle of the room. 
 To the north is the bathroom. The male bedrooms are to the northwest, and the female bedrooms are to the southwest. The door to the east leads outside

* * *

>n
(first opening door1)
It's locked. I guess I'll just have to hold it.

Bathroom
You can see door1 here.

>n
(first opening Bathroom door)
It seems to be locked.

* * *

>n
(first opening door1)
It's locked. I guess I'll just have to hold it.

Bathroom
You can see door1 here.

>look
Bathroom

>s
Main Room
Home sweet home for the rest of the expedition. There is a small kitchen area in the corner. All kinds of lab equipment is strewn across the tables in the middle of the room. 
 To the north is the bathroom. The male bedrooms are to the northwest, and the female bedrooms are to the southwest. The door to the east leads outside

>look
Main Room
Home sweet home for the rest of the expedition. There is a small kitchen area in the corner. All kinds of lab equipment is strewn across the tables in the middle of the room. 
 To the north is the bathroom. The male bedrooms are to the northwest, and the female bedrooms are to the southwest. The door to the east leads outside

* * *

>se
Common Room
Home sweet home for the rest of the expedition. There is a small kitchen area in the corner. All kinds of lab equipment is strewn across the tables in the middle of the room. 
 To the north is the bathroom. The male bedrooms are to the northwest, and the female bedrooms are to the southwest. The door to the east leads outside

You can see Base Door, Kitchen Table (on which is Sack Lunch) and a bathroom door here.

>e
(first opening Base Door)
I'll freeze to death if I go out there dressed like this!

>n
(first opening Bathroom door)
It's locked. I guess I'll just have to hold it.

You can't, since Bathroom door leads nowhere.

* * *

>e
(first opening Base Door)
I'll freeze to death if I go out there dressed like this!

>w
You can't go that way.

>nw
Sleeping Quarters Male
Sleeping quarters for the men on this expedition. To the southeast is the common room.

You can see Alarm Clock, a Wardrobe (closed) and a Backpack (closed) here.

>examine alarm clock
Is it that late already? I have to get to get to the dig site!

>open wardrobe
You open the Wardrobe, revealing Jacket.

>take jacket
Taken.

>wear jacket
You put on Jacket.

>take backpack
Taken.

* * *

>open backpack
You open the Backpack, revealing a pair of gloves, a hat, a Flashlight and a Flare.

>take gloves
Taken.

>wear gloves
You put on the pair of gloves.

>take hat
Taken.

>wear hat
You put on the hat.

>se
Common Room
Home sweet home for the rest of the expedition. There is a small kitchen area in the corner. All kinds of lab equipment is strewn across the tables in the middle of the room. 
 To the north is the bathroom. The male bedrooms are to the northwest, and the female bedrooms are to the southwest. The door to the east leads outside

You can see Base Door, Kitchen Table (on which is Sack Lunch) and a bathroom door here.

>take lunch
Taken.

>put lunch in backpack
You put Sack Lunch into the Backpack.

>close backpack
You close the Backpack.

>i
You are carrying:
  a hat (being worn)
  a pair of gloves (being worn)
  a Backpack (closed)
  Jacket (being worn)

>e
(first opening Base Door)

Outside the Base
To the north, you can see the covered area that houses the snowmobiles.

You can see Base Door here.

>n
Covered Area
You can see a Snowmobile here.

>use snowmobile
That's not a verb I recognise.

>use snowmobile
That's not a verb I recognise.

>use the snowmobile
That's not a verb I recognise.

>save
Save failed.

* * *

IFF
An Interactive Fiction by Joseph Farleo
Release 1 / Serial number 150406 / Inform 7 build 6L38 (I6/v6.33 lib 6/12N) SD

Sleeping Quarters Male
Sleeping quarters for the men on this expedition. To the southeast is the common room.

You can see an Alarm Clock, a Wardrobe (closed) and a Backpack (closed) here.

>open wardrobe
You open the Wardrobe, revealing Jacket.

>wear jacket
(first taking Jacket)
You put on Jacket.

>open backpack
You open the Backpack, revealing a pair of gloves, a hat, a Flashlight and a Flare.

* * *

>wear hat
(first taking the hat)
You put on the hat.

>se
Common Room
Home sweet home for the rest of the expedition. There is a small kitchen area in the corner. All kinds of lab equipment is strewn across the tables in the middle of the room. 
 To the north is the bathroom. The male bedrooms are to the northwest, and the female bedrooms are to the southwest. The door to the east leads outside

You can see Base Door, Kitchen Table (on which is Sack Lunch) and a bathroom door here.

>e
(first opening Base Door)

Outside the Base
To the north, you can see the covered area that houses the snowmobiles.

You can see Base Door here.

>n
Covered Area
All the other space for snowmobiles are empty.

You can see a Snowmobile and keys here.

* * *

>se
Common Room
Home sweet home for the rest of the expedition. There is a small kitchen area in the corner. All kinds of lab equipment is strewn across the tables in the middle of the room. 
 To the north is the bathroom. The male bedrooms are to the northwest, and the female bedrooms are to the southwest. The door to the east leads outside

You can see Base Door, Kitchen Table (on which is Sack Lunch) and a bathroom door here.

>w
You can't go that way.

>e
(first opening Base Door)

Outside the Base
To the north, you can see the covered area that houses the snowmobiles.

You can see Base Door here.

>n
Covered Area
All the other space for snowmobiles are empty.

You can see a Snowmobile here.

>look under snowmobile
You've discovered keys!

>i
You are carrying:
  keys
  a hat (being worn)
  a pair of gloves (being worn)
  Jacket (being worn)

>ride snowmobile
You mount the Snowmobile.

>look
Covered Area (on the Snowmobile)
All the other space for snowmobiles are empty.

* * *

>take backpack
Taken.

>se
Common Room
Home sweet home for the rest of the expedition. There is a small kitchen area in the corner. All kinds of lab equipment is strewn across the tables in the middle of the room. 
 To the north is the bathroom. The male bedrooms are to the northwest, and the female bedrooms are to the southwest. The door to the east leads outside

You can see Base Door, Kitchen Table (on which is Sack Lunch) and a bathroom door here.

* * *

>e
(first opening Base Door)

Outside the Base
To the north, you can see the covered area that houses the snowmobiles.

You can see Base Door here.

>n
Covered Area
You can see a Snowmobile and keys to the snowmobile here.

>enter snowmobile
Which do you mean, the Snowmobile or keys to the snowmobile?

>s
I only understood you as far as wanting to enter south.

>n
You can't go that way.

>dismount snowmobile
I only understood you as far as wanting to dismount.

>dismount
You are not riding anything.

>ride snowmobile
Which do you mean, the Snowmobile or keys to the snowmobile?

>dismount
You are not riding anything.

* * *

>ride snowmobile
Which do you mean, the Snowmobile or keys to the snowmobile?

>snowmobile
Which do you mean, the Snowmobile or keys to the snowmobile?

>ride the snowmobile
Which do you mean, the Snowmobile or keys to the snowmobile?

* * *

>open wardrobe
You open the Wardrobe, revealing Jacket.

>wear jacked
You can't see any such thing.

>wear jacket
(first taking Jacket)
You put on Jacket.

* * *

>e
(first opening Base Door)

Outside the Base
To the north, you can see the covered area that houses the snowmobiles.

You can see Base Door here.

>n
Covered Area
This is the area where we park the snowmibles. All the spaces for snowmobiles are empty except for one.

You can see a Snowmobile here.

>ride snowmobile
I can't start it without the keys.

>look under snowmobile
You've discovered keys!

* * *

>ride snowmobile
You mount the Snowmobile.

>dismount snowmobile
I only understood you as far as wanting to dismount.

>look
Dig Site
You can see Snowmobile ride ends on the second turn the player here.

* * *

IFF
An Interactive Fiction by Joseph Farleo
Release 1 / Serial number 150406 / Inform 7 build 6L38 (I6/v6.33 lib 6/12N) SD

Sleeping Quarters Male
Sleeping quarters for the men on this expedition. To the southeast is the common room.

You can see an Alarm Clock, a Wardrobe (closed) and a Backpack (closed) here.

>restore
Restore failed.

>restore
Restore failed.

>clear
What do you want to clear?

* * *

IFF
An Interactive Fiction by Joseph Farleo
Release 1 / Serial number 150406 / Inform 7 build 6L38 (I6/v6.33 lib 6/12N) SD

Sleeping Quarters Male
Sleeping quarters for the men on this expedition. To the southeast is the common room.

You can see an Alarm Clock, a Wardrobe (closed) and a Backpack (closed) here.

>examine alarm clock
Is it that late already? I have to get to get to the dig site!

>open wardrobe
You open Wardrobe, revealing Jacket.

>take jacket
Taken.

* * *

>take backpack
Taken.

>look
Sleeping Quarters Male
Sleeping quarters for the men on this mission. To the southeast is the common room.

You can see Alarm Clock and Wardrobe (empty) here.

>se
Common Room
Home sweet home for the rest of the expedition. There is a small kitchen area in the corner. All kinds of lab equipment is strewn across the tables in the middle of the room. 
 To the north is the bathroom. The male bedrooms are to the northwest, and the female bedrooms are to the southwest. The door to the east leads outside

You can see Kitchen Table (on which is Sack Lunch), Bathroom door and Outside the Base here.

>n
(first opening Bathroom door)
It's locked. I guess I'll just have to hold it.

>i
You are carrying:
  Backpack (closed)
  Jacket (being worn)

>open backpack
You open Backpack, revealing Pair of gloves, Hat, Flashlight and Flare.

>take lunch
Taken.

>put lunch in backpack
You put Sack Lunch into Backpack.

>close backpack
You close Backpack.