IFF
An Interactive Fiction by Joseph Farleo, Andrew Slembarski, and Sydney Young
Release 1 / Serial number 150412 / Inform 7 build 6L38 (I6/v6.33 lib 6/12N) SD

Male Sleeping Quarters
This is the male sleeping quarters for this expidition. The walls are covered in movie posters and there are odds and ends, dishes and cups strewn everywhere. Somewhere in this dump there are records of the history-altering discoveries this expidition has made. To the southeast is the common room.

You can see an Alarm Clock, a Wardrobe (closed) and a Backpack (closed) here.

>look around
Male Sleeping Quarters
This is the male sleeping quarters for this expidition. The walls are covered in movie posters and there are odds and ends, dishes and cups strewn everywhere. Somewhere in this dump there are records of the history-altering discoveries this expidition has made. To the southeast is the common room.

You can see an Alarm Clock, a Wardrobe (closed) and a Backpack (closed) here.

We come in peace. Take me to your leader. Klaatu barada nikto. Koona t'chuta Solo? All will be one. Resistance is futile. That's not what these glyphs say. You have no idea what the glyphs say. They won't make any sense without a translator.

>go southeast
Common Room
Home sweet home for the rest of the expedition. There is a small kitchen area in the corner. All kinds of lab equipment is strewn across the lab tables in the middle of the room, scientific research abandoned each morning to persue scientific FIELD research. You are not a scientist and do not understand what the other members of the expidition are doing when they peer at the artefacts they've uncovered and make sounds like 'hmm' and 'fascinating'.
 To the north is the bathroom. The male bedrooms are to the northwest, and the female bedrooms are to the southwest. The door to the east leads outside.

You can see Base Door, Kitchen Table (on which is a sack lunch (closed)), a Lab Tables (on which are a microscope, a preserved thoracic sac, an EDP (in which are a Chapter 1 and a Chapter 2) and a laser scalpel) and a bathroom door here.

We come in peace. Take me to your leader. Klaatu barada nikto. Koona t'chuta Solo? All will be one. Resistance is futile. That's not what these glyphs say. You have no idea what the glyphs say. They won't make any sense without a translator.

>go southwest
Female Sleeping Quarters
Sleeping quarters for the women on this expedition. It's rather rude of you to go snooping around people's personal spaces when they're not around, you know. Tsk. Don't expect to get invited to my house anytime soon. The room is far from tidy, but it seems impeccable compared to the rest of this outpost. There is a first-aid kit atop the side table, and a dresser in the far corner of the room. An Elvish Sword is mounted above one of the beds

You can see a first aid kit (in which are a tampon, a bandage and a granola bar), a Dresser (closed) and an Elvish Sword here.

We come in peace. Take me to your leader. Klaatu barada nikto. Koona t'chuta Solo? All will be one. Resistance is futile. That's not what these glyphs say. You have no idea what the glyphs say. They won't make any sense without a translator.

* * *

IFF
An Interactive Fiction by Joseph Farleo, Andrew Slembarski, and Sydney Young
Release 1 / Serial number 150412 / Inform 7 build 6L38 (I6/v6.33 lib 6/12N) SD

Male Sleeping Quarters
This is the male sleeping quarters for this expidition. The walls are covered in movie posters and there are odds and ends, dishes and cups strewn everywhere. Somewhere in this dump there are records of the history-altering discoveries this expidition has made. To the southeast is the common room.

You can see an Alarm Clock, a Wardrobe (closed) and a Backpack (closed) here.

>go southeast
Common Room
Home sweet home for the rest of the expedition. There is a small kitchen area in the corner. All kinds of lab equipment is strewn across the lab tables in the middle of the room, scientific research abandoned each morning to persue scientific FIELD research. You are not a scientist and do not understand what the other members of the expidition are doing when they peer at the artefacts they've uncovered and make sounds like 'hmm' and 'fascinating'.
 To the north is the bathroom. The male bedrooms are to the northwest, and the female bedrooms are to the southwest. The door to the east leads outside.

You can see Base Door, Kitchen Table (on which is a sack lunch (closed)), a Lab Tables (on which are a microscope, a preserved thoracic sac, an EDP (in which are a Chapter 1 and a Chapter 2) and a laser scalpel) and a bathroom door here.

We come in peace. Take me to your leader. Klaatu barada nikto. Koona t'chuta Solo? All will be one. Resistance is futile. That's not what these glyphs say. You have no idea what the glyphs say. They won't make any sense without a translator.

* * *

>examine dresser
You know, you shouldn't go through people's belongings without their permission, especailly when they're away. There are clothes in the dresser. Why would you want to root through people's clothes, anyway? Creep.

We come in peace. Take me to your leader. Klaatu barada nikto. Koona t'chuta Solo? All will be one. Resistance is futile. That's not what these glyphs say. You have no idea what the glyphs say. They won't make any sense without a translator.

>examine clothes
You can't see any such thing.

>take clothes
You can't see any such thing.

>open dresser
You open the Dresser, revealing a clothes.

We come in peace. Take me to your leader. Klaatu barada nikto. Koona t'chuta Solo? All will be one. Resistance is futile. That's not what these glyphs say. You have no idea what the glyphs say. They won't make any sense without a translator.

>take clothes
Those reallt don't suit your style. Also, they do not belong to you. They belong to someone else, who is not you. Please leave the clothes alone.

We come in peace. Take me to your leader. Klaatu barada nikto. Koona t'chuta Solo? All will be one. Resistance is futile. That's not what these glyphs say. You have no idea what the glyphs say. They won't make any sense without a translator.

* * *

IFF
An Interactive Fiction by Joseph Farleo, Andrew Slembarski, and Sydney Young
Release 1 / Serial number 150412 / Inform 7 build 6L38 (I6/v6.33 lib 6/12N) SD

Male Sleeping Quarters
This is the male sleeping quarters for this expidition. The walls are covered in movie posters and there are odds and ends, dishes and cups strewn everywhere. Somewhere in this dump there are records of the history-altering discoveries this expidition has made. To the southeast is the common room.

You can see an Alarm Clock, a Wardrobe (closed) and a Backpack (closed) here.

>take all
Backpack: Taken.

We come in peace. Take me to your leader. Klaatu barada nikto. Koona t'chuta Solo? All will be one. Resistance is futile. That's not what these glyphs say. You have no idea what the glyphs say. They won't make any sense without a translator.

>go southeast
Common Room
Home sweet home for the rest of the expedition. There is a small kitchen area in the corner. All kinds of lab equipment is strewn across the lab tables in the middle of the room, scientific research abandoned each morning to persue scientific FIELD research. You are not a scientist and do not understand what the other members of the expidition are doing when they peer at the artefacts they've uncovered and make sounds like 'hmm' and 'fascinating'.
 To the north is the bathroom. The male bedrooms are to the northwest, and the female bedrooms are to the southwest. The door to the east leads outside.

You can see Base Door, Kitchen Table (on which is a sack lunch (closed)), a Lab Tables (on which are a microscope, a preserved thoracic sac, an EDP (in which are a Chapter 1 and a Chapter 2) and a laser scalpel) and a bathroom door here.

We come in peace. Take me to your leader. Klaatu barada nikto. Koona t'chuta Solo? All will be one. Resistance is futile. That's not what these glyphs say. You have no idea what the glyphs say. They won't make any sense without a translator.

>take all
sack lunch: Taken.
EDP: Taken.
Chapter 1: Taken.
Chapter 2: Taken.
laser scalpel: Taken.

We come in peace. Take me to your leader. Klaatu barada nikto. Koona t'chuta Solo? All will be one. Resistance is futile. That's not what these glyphs say. You have no idea what the glyphs say. They won't make any sense without a translator.

>go east
(first opening Base Door)
You can't go out there dressed like this! Your tauntaun will freeze before you reach the first marker! 'Then I'll see you in hell', you chuckle to no-one in particular. What a nerd.

We come in peace. Take me to your leader. Klaatu barada nikto. Koona t'chuta Solo? All will be one. Resistance is futile. That's not what these glyphs say. You have no idea what the glyphs say. They won't make any sense without a translator.

>wear jacket
You can't see any such thing.

>take jacket
You can't see any such thing.

>open backpack
You open the Backpack, revealing a pair of gloves, a hat, a Flashlight and a Flare.

We come in peace. Take me to your leader. Klaatu barada nikto. Koona t'chuta Solo? All will be one. Resistance is futile. That's not what these glyphs say. You have no idea what the glyphs say. They won't make any sense without a translator.

>wear gloves
(first taking the pair of gloves)
You put on the pair of gloves.

We come in peace. Take me to your leader. Klaatu barada nikto. Koona t'chuta Solo? All will be one. Resistance is futile. That's not what these glyphs say. You have no idea what the glyphs say. They won't make any sense without a translator.

>wear hat
(first taking the hat)
You put on the hat.

We come in peace. Take me to your leader. Klaatu barada nikto. Koona t'chuta Solo? All will be one. Resistance is futile. That's not what these glyphs say. You have no idea what the glyphs say. They won't make any sense without a translator.