IFF
An Interactive Fiction by Joseph Farleo, Andrew Slembarski, and Sydney Young
Release 1 / Serial number 150408 / Inform 7 build 6L38 (I6/v6.33 lib 6/12N) SD

Male Sleeping Quarters
Sleeping quarters for the men on this expedition. To the southeast is the common room.

You can see an Alarm Clock, a Wardrobe (closed) and a Backpack (closed) here.

>open wardrobe
You open the Wardrobe, revealing Coat.

>take coat
Taken.

>put on coat
You put on Coat.

>open backpack
You open the Backpack, revealing a pair of gloves, a hat, a Flashlight and a Flare.

* * *

>close backpack
You close the Backpack.

>take back pack
You can't see any such thing.

>take backpack
Taken.

>examine room
You can't see any such thing.

>look around
You can't see any such thing.

>se
Common Room
Home sweet home for the rest of the expedition. There is a small kitchen area in the corner. All kinds of lab equipment is strewn across the tables in the middle of the room. 
 To the north is the bathroom. The male bedrooms are to the northwest, and the female bedrooms are to the southwest. The door to the east leads outside

You can see Base Door, Kitchen Table (on which is a Sack Lunch (closed)), Tables (on which are a microscope, a preserved thoracic sac and an EDP (in which are a Chapter 1 and a Chapter 2)) and a bathroom door here.

* * *

>open wardrobe
You open the Wardrobe, revealing Coat.

>put on coat
(first taking Coat)
You put on Coat.

>take backpack
Taken.

>se
Common Room
Home sweet home for the rest of the expedition. There is a small kitchen area in the corner. All kinds of lab equipment is strewn across the tables in the middle of the room. 
 To the north is the bathroom. The male bedrooms are to the northwest, and the female bedrooms are to the southwest. The door to the east leads outside.

You can see Base Door, Kitchen Table (on which is a Sack Lunch (closed)), Tables (on which are a microscope, a preserved thoracic sac and an EDP (in which are a Chapter 1 and a Chapter 2)) and a bathroom door here.

>open bathroom door
It's locked. I guess I'll just have to hold it.

>examine kitchen table
On Kitchen Table is a Sack Lunch (closed).

>take lunch
Taken.

>open sack
You open the Sack Lunch, revealing a PB & J sandwich, an apple and a sweetroll.

>examine sandwich
A PB & J sandwich with the perfect ratio and pleasantly soft, yet not soggy, bread

>eat sanwich
You can't see any such thing.

>eat sandwich
(first taking the PB & J sandwich)
You eat the PB & J sandwich. Not bad.

>examine apple
A Honeycrisp Apple. The superior apple, ever since you discovered Red Delicious Apples were filled of lies

>examine sweetroll
A sweetroll. A roll that is sweet. Duh

>close sack
You close the Sack Lunch.

>examine tables
Craig and Reala were working on examining the molecular structure of the Phosphorescent Space Penguins" thoracic sacs. Originally used as a mating and warning signal, the sacs might allow us to use the cells for more efficient glow-in-the-dark stuff. But our job isn't to find a use for it anyway. That's the engineers" concern.

On Tables are a microscope, a preserved thoracic sac and an EDP (in which are a Chapter 1 and a Chapter 2).

>examine edp
The Environmental Discovery Pager. Each of the archeologists is supposed to have one. Looks like Carl forgot to take his with him. Again. I had better return it to him. 

 The EDP currently has Chapter 1 and Chapter 2 completed

In the EDP are a Chapter 1 and a Chapter 2.

>read chapter 1
It reads "A bad start already, dang it. There's a really cool ice cave filled with all sorts of specimens on the first floor of the caverns, but I left this darn thing up here again. I left my observations of the species in the cavern on the icy ledge where Russeau was deciphering the glyphs. He said he'd left it there, and I haven't been able to remember to bring it back to base yet. My memory has never been impressive."

>read chapter 2
It reads "The second level of the caverns is even more amazing! I still cannot believe I forgot this EDP back here again. I left my notes for that section of the cavern...shoot, I don't even remember where I put them! I remember Russeau saying something about the first layer's inhabitants being a sort of translating explorative species based on his findings, and he sounded excited to search the seond level for more glyphs from their discoveries. Perhaps they know even more about this planet's history than we do!"

>take EDP
Taken.

>examine self
As good-looking as ever.

>base door
That's not a verb I recognise.

>examine tables
Craig and Reala were working on examining the molecular structure of the Phosphorescent Space Penguins" thoracic sacs. Originally used as a mating and warning signal, the sacs might allow us to use the cells for more efficient glow-in-the-dark stuff. But our job isn't to find a use for it anyway. That's the engineers" concern.

On Tables are a microscope and a preserved thoracic sac.

>take sac
I am not taking that nasty, slimy thing with me. No way.

>examine sac
Gross.

>examine microscope
The microscope has been in Reala's family for generations. Outdated, but still operational.

>look through microscope
Glowy stuff, glowy stuff, and more glowy stuff. Only the biologists really know what to make of whatever the heck this stuff is.

>use microscope
Glowy stuff, glowy stuff, and more glowy stuff. Only the biologists really know what to make of whatever the heck this stuff is.

>take microscope
Why would you need a microscope?

>examine room
You can't see any such thing.

>east
(first opening Base Door)
I'll freeze to death if I go out there dressed like this!

>open backpack
You open the Backpack, revealing a pair of gloves, a hat, a Flashlight and a Flare.

* * *

>close backpack
You close the Backpack.

>eat
What do you want to eat?

>e
You can't see any such thing.

>east
(first opening Base Door)

Outside the Base
To the north, you can see the covered area that houses the snowmobiles.

You can see Base Door here.

>open door
That's already open.

>s
You can't go that way.

>n
Garage
This is the area where we park the snowmobiles. All the spaces for snowmobiles are empty except for one.

You can see garage door and a Snowmobile here.

>mount snowmobile
I can't start it without the keys.

>examine snowmobile
There appears to be something shiny underneath it.

>look under snowmobile
You've discovered keys!

>i
You are carrying:
  keys
  a hat (being worn)
  a pair of gloves (being worn)
  an EDP
    a Chapter 1
    a Chapter 2
  a Sack Lunch (closed)
  a Backpack (closed)
  Coat (being worn)

>examine coat
Puffed up to the brim with the finest Groobler feathers. This blue coat is sure to keep me nice and toasty down to 50 Kelvin.

>mount snowmobile
You mount the Snowmobile.

>s
Outside the Base (on the Snowmobile)
To the north, you can see the covered area that houses the snowmobiles.

You can see Base Door here.

>s
You can't go that way.

* * *

IFF
An Interactive Fiction by Joseph Farleo, Andrew Slembarski, and Sydney Young
Release 1 / Serial number 150408 / Inform 7 build 6L38 (I6/v6.33 lib 6/12N) SD

Male Sleeping Quarters
Sleeping quarters for the men on this expedition. To the southeast is the common room.

You can see an Alarm Clock, a Wardrobe (closed) and a Backpack (closed) here.

>take alarm clock
Why would you need to bring your alarm clock with you?

>open wardrobe
You open the Wardrobe, revealing a coat.

>put on coat
(first taking the coat)
You put on the coat.

>take backpack
Taken.

* * *

>put on hat
(first taking the hat)
You put on the hat.

>close packpack
You can't see any such thing.

>clos backpack
That's not a verb I recognise.

>close backpack
You close the Backpack.

>se
Common Room
Home sweet home for the rest of the expedition. There is a small kitchen area in the corner. All kinds of lab equipment is strewn across the tables in the middle of the room. 
 To the north is the bathroom. The male bedrooms are to the northwest, and the female bedrooms are to the southwest. The door to the east leads outside.

You can see Base Door, Kitchen Table (on which is a Sack Lunch (closed)), Tables (on which are a microscope, a preserved thoracic sac, an EDP (in which are a Chapter 1 and a Chapter 2) and a scalpel) and a bathroom door here.

>examine table
On Kitchen Table is a Sack Lunch (closed).

>take sack lunch
Taken.

>open lunch
You open the Sack Lunch, revealing a PB & J sandwich, an apple and a sweetroll.

>examine sandwich
A PB & J sandwich with the perfect ratio and pleasantly soft, yet not soggy, bread

>examine apple
A Honeycrisp Apple. The superior apple, ever since you discovered Red Delicious Apples were filled of lies

>examine sweetroll
A sweetroll. A roll that is sweet. Duh.

>examine roll
You can't see any such thing.

>close sack
You close the Sack Lunch.

>examine microscope
The microscope has been in Reala's family for generations. Outdated, but still operational.

* * *

>look through microscope
Glowy stuff, glowy stuff, and more glowy stuff. Only the biologists really know what to make of whatever the heck this stuff is.

>open door
Which do you mean, Base Door or the bathroom door?

>open bathroom door
It's locked. I guess I'll just have to hold it.

>take edp
Taken.

* * *

>se
You can't go that way.

>examine tables
Craig and Reala had been working on examining the molecular structure of the Phosphorescent Space Penguin thoracic sac. Originally used as a mating and warning signal, the sac cells might allow us to create more efficient glow-in-the-dark stuff. But our job isn't to find a use for it anyway. That's the engineers" concern.

On Tables are a microscope, a preserved thoracic sac and a scalpel.

>take scalpel
Taken.

>examine scalpel
A laser scalpel. Makes clean cuts. Don't want to be on the wrong end of one.

>examine sac
Gross.

>take sac
I am not taking that nasty, slimy thing with me. No way.

>examine table
You see nothing special about Kitchen Table.

>examine tables
Craig and Reala had been working on examining the molecular structure of the Phosphorescent Space Penguin thoracic sac. Originally used as a mating and warning signal, the sac cells might allow us to create more efficient glow-in-the-dark stuff. But our job isn't to find a use for it anyway. That's the engineers" concern.

On Tables are a microscope and a preserved thoracic sac.

>i
You are carrying:
  a scalpel
  an EDP
    a Chapter 1
    a Chapter 2
  a Sack Lunch (closed)
  a hat (being worn)
  a pair of gloves (being worn)
  a Backpack (closed)
  a coat (being worn)

>se
You can't go that way.

>sw
Female Sleeping Quarters
Sleeping quarters for the women on this expedition. To the northeast is the common room.

This sword is a collectors item of Reala's. She claims it glows blue when danger is near. Riiiight.

You can also see a first aid kit (in which are a tampons, a bandage and a granola bar) and a Dresser (closed) here.

>examine swrod
You can't see any such thing.

>examine sword
You see nothing special about the Elvish Sword.

>take swrod
You can't see any such thing.