IFF
An Interactive Fiction by Joseph Farleo, Andrew Slembarski, and Sydney Young
Release 1 / Serial number 150412 / Inform 7 build 6L38 (I6/v6.33 lib 6/12N) SD

Male Sleeping Quarters
This is the male sleeping quarters for this expidition. The walls are covered in movie posters and there are odds and ends, dishes and cups strewn everywhere. Somewhere in this dump there are records of the history-altering discoveries this expidition has made. To the southeast is the common room.

You can see an Alarm Clock, a Wardrobe (closed) and a Backpack (closed) here.

>wardrobe
That's not a verb I recognise.

>open wardrobe
You open the Wardrobe, revealing a coat.

* * *

>wear hat
(first taking the hat)
You put on the hat.

>se
Common Room
Home sweet home for the rest of the expedition. There is a small kitchen area in the corner. All kinds of lab equipment is strewn across the lab tables in the middle of the room, scientific research abandoned each morning to persue scientific FIELD research. You are not a scientist and do not understand what the other members of the expidition are doing when they peer at the artefacts they've uncovered and make sounds like 'hmm' and 'fascinating'.
 To the north is the bathroom. The male bedrooms are to the northwest, and the female bedrooms are to the southwest. The door to the east leads outside.

You can see Base Door, Kitchen Table (on which is a sack lunch (closed)), a Lab Tables (on which are a microscope, a preserved thoracic sac, an EDP (in which are a Chapter 1 and a Chapter 2) and a laser scalpel) and a bathroom door here.

>take laser scalpel
Taken.

>e
(first opening Base Door)

Outside the Base
Kind of nippy out here. To the north, you can see the covered area that houses the snowmobiles.

You can see Base Door here.

* * *

>ride snowmobile
You mount the Snowmobile.

>e
(first opening the Garage Door)

Dig Site (on the Snowmobile)
To the north is the elevator that leads down the hole. You can see a ladder leading up to the drilling rig. In the distance to the east, you can barely see the outline of the garage door

You can see ladder, a Garage Door and Elevator Door here.

>dismount
You dismount the Snowmobile.

Dig Site
To the north is the elevator that leads down the hole. You can see a ladder leading up to the drilling rig. In the distance to the east, you can barely see the outline of the garage door

You can see ladder, a Garage Door, a Snowmobile and Elevator Door here.

>up
Drilling rig
Controls for the laser drill used to create the hole in the ice. You probably shouldn't mess with them

You can see ladder, a rope, Level 1 Keycard and Space Suit here.

>take rope
Taken.

>wear space suit
(first taking Space Suit)
You put on Space Suit.

>take level 1 keycard
Taken.

>d
Dig Site
To the north is the elevator that leads down the hole. You can see a ladder leading up to the drilling rig. In the distance to the east, you can barely see the outline of the garage door

You can see ladder, a Garage Door, a Snowmobile and Elevator Door here.

>n
(first opening Elevator Door)

Elevator
Ground Level.

You can see Elevator Door and Elevator Door here.

* * *

>take ice pick
Taken.

You combine the rope with the ice pick to make a makeshift grappling hook.

>w
Specimen Room
The artifact room is back to the east.

You can see Portable Laser Jackhammer (Uncharged) here.

>take portable
You use the ice pick to break the tool out of the ice.

Taken.

>look
Specimen Room
The artifact room is back to the east.

>e
Artifact room
There is another room to the east.

You can see Supply crate (empty) here.

* * *

>e
Ledge Room.
The artifact room is back to the west.

You can see Ledge and Broken Ladder here.

>take broken ladder
Taken.

* * *

>n
You use pieces of the broken ladder to make a path across to the other side.

Second Ledge
The first ledge is back to the south across the pit. There is another ledge above you.

>u
You throw your maksehift grappling hook and it catches in the ice. You can now climb the rope to reach the third ledge
Third Ledge
You can see Translation Matrix and Mysterious Glyphs here.

>take translation matrix
Taken.

>examine mysterious glyphs
The glyphs start to make sense. They say "" .

>d
Second Ledge
The first ledge is back to the south across the pit. There is another ledge above you.

>s
First Ledge
To the north, across the bottomless pit, you see another ledge. A third appears to be above it. The broken ladder now acts as a bridge across the gap.

You can see Ledge here.

>w
You can't go that way.

>d
Ledge Room.
The artifact room is back to the west.

You can see Ledge here.

>w
Artifact room
There is another room to the east.

You can see Supply crate (empty) here.

>n
Elevator
Level 1.

You can see Elevator Door and Elevator Door here.

>d
(first opening Elevator Door)

Elevator
Level 2.

You can see Elevator Door and Backup Power Cell here.

>take backup power cell
Taken.

You use the power cell from the elevator to power the jackhammer.

>i
You are carrying:
  Portable Laser Jackhammer (Charged)
  Translation Matrix
  Makeshift Grappling Hook
  Level 1 Keycard
  Space Suit (being worn)
  keys
  a laser scalpel
  a hat (being worn)
  a pair of gloves (being worn)
  a coat (being worn)

>d
You can't go that way.

>s
Room 1
.

You can see Patch of thin ice here.

>melt patch
You use the laser jackhammer to melt the patch of thin ice.

>w
Underwater tunnel
.

>u
Secret Cavern
.

You can see Spear Gun here.

>take spear gun
Taken.

>d
Underwater tunnel
.

>e
Room 1
.

>e
Ship Room
.

You can see a Ship door here.

>open ship door
It seems to be locked.

>set ship door to 23
You enter 23 on the Ship Door.

>set ship door to 16
You enter 16 on the Ship Door.

>set ship door to 09
You enter 9, and the Ship door gives a joyous CLICK.

>e
(first opening the Ship door)

Control Room
.

You can see a Ship door and Big Red Button here.

>push big red button
Nothing happens. The ship's power appears to be off.

>d
Engine Room
.

You can see Compartment 1 (closed), Compartment 2 (closed), Compartment 3 (closed) and Compartment 4 (closed) here.

>open compartment 1
You open Compartment 1, revealing wires 1.

>examine wires
.

>open compartment
Which do you mean, Compartment 1, Compartment 2, Compartment 3 or Compartment 4?

>open compartment 2
You open Compartment 2, revealing wires 2.

>examine wires
Which do you mean, wires 1 or wires 2?

>examine wires in compartment 1
You can't see any such thing.

>examine wires 1
.

>open compartment 3
You open Compartment 3, revealing wires 3.

>solder wires 3
You manage to connect the two wire together using the laser scalpel. The ship should have power now.

>u
Control Room
.

You can see a Ship door and Big Red Button here.