IFF
An Interactive Fiction by Joseph Farleo, Andrew Slembarski, and Sydney Young
Release 1 / Serial number 150411 / Inform 7 build 6L38 (I6/v6.33 lib 6/12N) SD

Male Sleeping Quarters
Sleeping quarters for the men on this expedition. To the southeast is the common room.

You can see an Alarm Clock, a Wardrobe (closed) and a Backpack (closed) here.

>open wardrobe
You open the Wardrobe, revealing a coat.

* * *

>wear hat
(first taking the hat)
You put on the hat.

>se
Common Room
Home sweet home for the rest of the expedition. There is a small kitchen area in the corner. All kinds of lab equipment is strewn across the lab tables in the middle of the room. 
 To the north is the bathroom. The male bedrooms are to the northwest, and the female bedrooms are to the southwest. The door to the east leads outside.

You can see Base Door, Kitchen Table (on which is a sack lunch (closed)), a Lab Tables (on which are a microscope, a preserved thoracic sac, an EDP (in which are a Chapter 1 and a Chapter 2) and a scalpel) and a bathroom door here.

>e
(first opening Base Door)

Outside the Base
Kind of nippy out here. To the north, you can see the covered area that houses the snowmobiles.

You can see Base Door here.

>n
Garage
This is the area where we park the snowmobiles. All the spaces for snowmobiles are empty except for one.

You can see a Garage Door and a Snowmobile here.

>look under snowmobile
You've discovered keys!

* * *

>ride snowmobile
You mount the Snowmobile.

>e
(first opening the Garage Door)

Dig Site (on the Snowmobile)
To the north is the elevator that leads down the hole. You can see a ladder leading up to the drilling rig. In the distance to the  east, you can barely see the outline of the garage door

You can see ladder, a Garage Door and Elevator Door here.

>dismount
You dismount the Snowmobile.

Dig Site
To the north is the elevator that leads down the hole. You can see a ladder leading up to the drilling rig. In the distance to the  east, you can barely see the outline of the garage door

You can see ladder, a Garage Door, a Snowmobile and Elevator Door here.

>up
(first opening ladder)

Drilling rig
Controls for the laser drill used to create the hole in the ice. You  probably shouldn't mess with them

You can see ladder, a rope and Level 1 Keycard here.

>take rope
Taken.

>take keycard
Taken.

>s
You can't go that way.

>d
Dig Site
To the north is the elevator that leads down the hole. You can see a ladder leading up to the drilling rig. In the distance to the  east, you can barely see the outline of the garage door

You can see ladder, a Garage Door, a Snowmobile and Elevator Door here.

>n
(first opening Elevator Door)

Elevator
Ground Level.

You can see Elevator Door and Elevator Door here.

>d
(first opening Elevator Door)

Elevator
Level 1.

You can see Elevator Door and Elevator Door here.

>i
You are carrying:
  Level 1 Keycard
  a rope
  keys
  a hat (being worn)
  a pair of gloves (being worn)
  a coat (being worn)

>d
(first opening Elevator Door)

Elevator
Level 2.

You can see Elevator Door here.

>s
You can't go that way.

>n
You can't go that way.

>u
Elevator
Level 1.

You can see Elevator Door and Elevator Door here.

>s
Artifact room
There is another room to the east.

You can see Supply crate (in which is an ice pick) here.

>n
Elevator
Level 1.

You can see Elevator Door and Elevator Door here.

>d
Elevator
Level 2.

You can see Elevator Door here.

>s
You can't go that way.

>u
Elevator
Level 1.

You can see Elevator Door and Elevator Door here.

* * *

>s
Artifact room
There is another room to the east.

You can see Supply crate (in which is an ice pick) here.

>look
Artifact room
There is another room to the east.

You can see Supply crate (in which is an ice pick) here.

>take ice pick
Taken.

You combine the rope with the ice pick to make a makeshift grappling hook.

* * *

>dismount
You dismount the Snowmobile.

Dig Site
To the north is the elevator that leads down the hole. You can see a ladder leading up to the drilling rig. In the distance to the  east, you can barely see the outline of the garage door

You can see ladder, a Garage Door, a Snowmobile and Elevator Door here.

>u
Drilling rig
Controls for the laser drill used to create the hole in the ice. You  probably shouldn't mess with them

You can see ladder, a rope and Level 1 Keycard here.

>take rope
Taken.

>take level 1 keycard
Taken.

>s
You can't go that way.

* * *

>d
(first opening Elevator Door)

Elevator
Level 1.

You can see Elevator Door and Elevator Door here.

>s
Artifact room
There is another room to the east.

You can see Supply crate (in which is an ice pick) here.

>take ice pick
Taken.

You combine the rope with the ice pick to make a makeshift grappling hook.

>w
Specimen Room
The artifact room is back to the east.

You can see Portable Laser Jackhammer U here.

>take portable
You use the ice pick to break the tool out of the ice.

Taken.

>examine portable
The power cell appears to be missing.

>e
Artifact room
There is another room to the east.

You can see Supply crate (empty) here.

>e
Ledge Room.
The artifact room is back to the west.

You can see Ledge and Broken Ladder here.

>climb ledge 1
I only understood you as far as wanting to climb Ledge.

>climb onto ledge 1
You can't see any such thing.

>climb
What do you want to climb?

>climb ledge 1
I only understood you as far as wanting to climb Ledge.

>climb ledge
First Ledge
To the north, across the bottomless pit, you see another ledge. A third appears to be above it.

You can see Ledge and Bottomless Pit here.

>climb a ledge
Ledge Room.
The artifact room is back to the west.

You can see Ledge and Broken Ladder here.

>climb a Ledge
First Ledge
To the north, across the bottomless pit, you see another ledge. A third appears to be above it.

You can see Ledge and Bottomless Pit here.

>climb Ledge
Ledge Room.
The artifact room is back to the west.

You can see Ledge and Broken Ladder here.

>examine ledge
You see nothing special about Ledge.

>look
Ledge Room.
The artifact room is back to the west.

You can see Ledge and Broken Ladder here.

>climb ledge1
You can't see any such thing.

>climb ledge
First Ledge
To the north, across the bottomless pit, you see another ledge. A third appears to be above it.

You can see Ledge and Bottomless Pit here.

>d
Ledge Room.
The artifact room is back to the west.

You can see Ledge and Broken Ladder here.

>take broken ladder
Taken.

>u
First Ledge
To the north, across the bottomless pit, you see another ledge. A third appears to be above it.

You can see Ledge and Bottomless Pit here.

>n
You use pieces of the broken ladder to make a path across to the other side.

(first opening Bottomless Pit)

Second Ledge
The first ledge is back to the south across the pit. There is another ledge above you.

You can see Bottomless Pit here.

>s
First Ledge
To the north, across the bottomless pit, you see another ledge. A third appears to be above it. The broken ladder now acts as a bridge across the gap.

You can see Bottomless Pit and Ledge here.

>n
It's much too far to jump.

>i
You are carrying:
  Portable Laser Jackhammer U
  Makeshift Grappling Hook
  Level 1 Keycard
  keys
  a hat (being worn)
  a pair of gloves (being worn)
  a coat (being worn)

>s
You can't go that way.

>drop broken ladder
You can't see any such thing.

>n
It's much too far to jump.

>s
You can't go that way.

>close bottomless pit
You close Bottomless Pit.

>n
It's much too far to jump.

* * *

>take level 1 keycard
Taken.

>i
You are carrying:
  Level 1 Keycard
  a rope
  keys
  a hat (being worn)
  a pair of gloves (being worn)
  a coat (being worn)

>d
Dig Site
To the north is the elevator that leads down the hole. You can see a ladder leading up to the drilling rig. In the distance to the  east, you can barely see the outline of the garage door

You can see ladder, a Garage Door, a Snowmobile and Elevator Door here.

* * *

>take ice pick
Taken.

You combine the rope with the ice pick to make a makeshift grappling hook.

>e
Ledge Room.
The artifact room is back to the west.

You can see Ledge and Broken Ladder here.

>climb ledge
First Ledge
To the north, across the bottomless pit, you see another ledge. A third appears to be above it.

You can see Ledge here.

>n
It's much too far to jump.

>n
It's much too far to jump.

>d
Ledge Room.
The artifact room is back to the west.

You can see Ledge and Broken Ladder here.

* * *

>take broken ladder
Taken.

>u
First Ledge
To the north, across the bottomless pit, you see another ledge. A third appears to be above it.

You can see Ledge here.

>n
You use pieces of the broken ladder to make a path across to the other side.

Second Ledge
The first ledge is back to the south across the pit. There is another ledge above you.

>s
First Ledge
To the north, across the bottomless pit, you see another ledge. A third appears to be above it. The broken ladder now acts as a bridge across the gap.

You can see Ledge here.

>n
Second Ledge
The first ledge is back to the south across the pit. There is another ledge above you.

>i
You are carrying:
  Makeshift Grappling Hook
  Level 1 Keycard
  keys
  a hat (being worn)
  a pair of gloves (being worn)
  a coat (being worn)

>drop makeshift
Dropped.

>u
You can't reach the third ledge from all the way down here.

>take makeshift
Taken.

* * *

>open wardrobe
You open the Wardrobe, revealing a coat.

>take jacket
Taken.

>wear jacket
You put on the coat.

>take backpack
Taken.

>wear gloves
You can't see any such thing.

>open backpack
You open the Backpack, revealing a pair of gloves, a hat, a Flashlight and a Flare.

* * *

>look under snowmobile
You've discovered keys!

>take keys
You already have that.

>ride snow
You can't see any such thing.

>ride snowmobile
You mount the Snowmobile.

* * *

>e
(first opening the Garage Door)

Dig Site (on the Snowmobile)
To the north is the elevator that leads down the hole. You can see a ladder leading up to the drilling rig. In the distance to the  east, you can barely see the outline of the garage door

You can see ladder, a Garage Door and Elevator Door here.

>up
(first opening ladder)
You should maybe dismount the snowmobile first.

>take rope
You can't see any such thing.

>take keycard
You can't see any such thing.

>d
You can't go that way.

>n
(first opening Elevator Door)
You should maybe dismount the snowmobile first.

>s
You can't go that way.

>dismount snowmobile
I only understood you as far as wanting to dismount.

>dismount
You dismount the Snowmobile.

Dig Site
To the north is the elevator that leads down the hole. You can see a ladder leading up to the drilling rig. In the distance to the  east, you can barely see the outline of the garage door

You can see ladder, a Garage Door, a Snowmobile and Elevator Door here.

>n
(first opening Elevator Door)

Elevator
Ground Level.

You can see Elevator Door and Elevator Door here.

>d
(first opening Elevator Door)
ACCESS DENIED

>d
(first opening Elevator Door)
ACCESS DENIED

>i
You are carrying:
  keys
  a hat (being worn)
  a pair of gloves (being worn)
  a Backpack (open)
    a Flashlight
    a Flare
  a coat (being worn)

>looj
That's not a verb I recognise.

>look
Elevator
Ground Level.

You can see Elevator Door and Elevator Door here.

>s
Dig Site
To the north is the elevator that leads down the hole. You can see a ladder leading up to the drilling rig. In the distance to the  east, you can barely see the outline of the garage door

You can see Elevator Door, ladder, a Garage Door and a Snowmobile here.

>up
(first opening ladder)

Drilling rig
Controls for the laser drill used to create the hole in the ice. You  probably shouldn't mess with them

You can see ladder, a rope and Level 1 Keycard here.

>take level 1
Taken.

>d
Dig Site
To the north is the elevator that leads down the hole. You can see a ladder leading up to the drilling rig. In the distance to the  east, you can barely see the outline of the garage door

You can see ladder, Elevator Door, a Garage Door and a Snowmobile here.

>n
Elevator
Ground Level.

You can see Elevator Door and Elevator Door here.